7 7 7 7 7 7 7 7 7 7 7 7 7 7 7 10 10
8 8 7 7 7 8 7 7 8 7 7 7 8 7 7 10 10 
7 7 8 8 7 7 7 7 8 7 7 7 7 7 7 10 10 
7 7 7 7 8 7 8 7 7 7 8 7 8 8 7 10 10 
8 8 7 7 7 8 7 7 8 7 7 7 8 7 7 10 10
7 7 8 8 7 7 7 7 8 7 7 7 7 7 7 10 10
7 7 7 7 8 7 8 7 7 7 8 7 8 8 7 10 10
8 8 7 7 7 8 7 7 8 7 7 7 8 7 7 10 10
7 7 8 8 7 7 7 7 8 7 7 7 7 7 7 10 10
7 7 7 7 8 7 8 7 7 7 8 7 8 8 7 10 10
8 8 7 7 7 8 7 7 8 7 7 7 8 7 7 10 10
7 7 8 8 7 7 7 7 8 7 7 7 7 7 7 10 10
7 7 7 7 8 7 8 7 7 7 8 7 8 8 7 10 10
8 8 7 7 7 8 7 7 8 7 7 7 8 7 7 10 10
7 7 8 8 7 7 7 7 8 7 7 7 7 7 7 10 10