0 0 0 0 0 0 0 0 0 0 0 0 0 0 0 0 0 9 0 9
0 2 1 1 1 1 2 0 0 0 0 0 0 0 0 0 0 0 0 9
0 0 3 3 3 3 2 0 0 0 0 0 0 0 0 0 0 0 0 9
0 2 3 3 3 3 2 0 0 0 0 0 0 0 0 0 0 0 0 9
0 2 3 3 3 3 2 0 0 0 0 0 0 0 0 0 0 0 0 9
0 1 1 1 3 1 1 0 0 0 0 0 0 0 0 0 0 0 0 9
0 0 0 0 7 0 6 0 0 0 0 0 0 0 0 0 0 0 0 9
0 0 4 4 7 4 5 6 0 0 0 0 0 0 0 0 0 0 0 9
0 0 0 5 7 0 5 0 0 0 0 0 0 0 0 0 0 0 0 9
9 9 9 9 7 0 0 0 0 0 0 0 0 0 0 0 0 0 0 9
0 0 0 0 0 0 0 0 0 0 0 0 0 0 0 0 0 0 0 9
0 2 1 1 1 1 2 0 0 0 0 0 0 0 0 0 0 0 0 9
0 2 3 3 3 3 2 0 0 0 0 0 0 0 0 0 0 0 0 9
0 2 3 3 3 3 2 0 0 0 0 0 0 0 0 0 0 0 0 9
0 2 3 3 3 3 2 0 0 0 0 0 0 0 0 0 0 0 0 9
0 1 1 1 3 1 1 0 0 0 0 0 0 0 0 0 0 0 0 9
0 0 0 0 7 0 6 0 0 0 0 0 0 0 0 0 0 0 0 9
0 0 4 4 7 4 5 6 0 0 0 0 0 0 0 0 0 0 0 9
0 0 0 5 7 0 5 0 0 0 0 0 0 0 0 0 0 0 0 9
9 9 9 9 7 0 0 0 0 0 0 0 0 0 0 0 0 0 0 9
